








000000000000000000000000000000000000000000000000000000000000000000000000000000000000
000000000000000000000000000000000000000000000000000000000000000000000000000000000000
000000000000000000000000000000000000000000000000000000000000000000000000000000000000
000000000000000000000000000000000000000000000000000000000000000000000000000000000000
000000000000000000000000000000000000000000000000000000000000000000000000000000000000
000000000000000000000000000000000000000000000000000000000000000000000000000000000000
000000000000000000000000000000000000000000000000000000000000000000000000000000000000
000220000000000222200000000000000000000000000000000000000000000000000000000000000000
000000000022222111120000000000000000000000000000000000000000000000000000000000000000
000000002211111110000000000000000000000000000000000000000000000000000000000000000000
000000221110000000000000000000000000000000000000000000000000000000000000000000000000
000000000000000000000000000000000000000000000000000000000000000000000000000000000000
000000000000000000000000000000000000000000000000000000000000000000000000000000000000
000000000000000000000002200000000000000000000000000000000000000000000000000000000000
220000022220000000022221122222222220000022220000000000000000000000000000000000000000
112222211112000002211111111111111112222211112220000000000000000000000000000000000000
111111111111200021111111111111111111111111111112000000000000000000000000000000000000
111111111111100011111111111111111111111111111111000000000000000000000000000000000000
111111111111100011111111111111111111111111111111000000000000000000000000000000000000
111111111111100011111111111111111111111111111111000000000000000000000000000000000000
111111111111100011111111111111111111111111111111000000000000000000000000000000000000
111111111111100011111111111111111111111111111111000000000000000000000000000000000000
111111111111100011111111111111111111111111111111000000000000000000000000000000000000
