0000000000000000000000000000
0000000000000000000000000000
0000000000000000000000000000
0000000000000000000000000000
0022222000222220002222200000
0020000202000002020000020000
0020000202000002020000000000
0020000202000002020000000000
0020000202000002020000000000
0022222002000002020000000000
0020000002000002020022200000
0020000002000002020000020000
0020000002000002020000020000
0020000002000002020000020000
0020000000222220002222200000
0000000000000000000000000000
0000000000000000000000000000